111111111111111111111111111111111111111111111111111111
111101100000000000000111111110111111000011000000100001
100000000011111111110000000000000000000000011110001101
111011110110001000000111111011111111111111110000111101
100000000110001000000100000010000000000000000111111101
101111111110101000000100000010000111111111111100000001
100000000000100011111100000010000100000000000001111111
111111111111111111111100000010111100000000000001000001
100001000010000000100000000010111100000000000001000001
100000011000111110001100000010000100000000000001000001
100001110010001111111100000010000100000000000001000001
100001000110101000000100000010000100000000000001000001
100001011110100010112100000000000000000000000000000001
111111111111111111111111111111111111111111111111111111
