111111111115555555551111111155511111111111111111111111
1111011000c0000000000111111150555555000011000000100001
100000c000155555555503c0cccc300000080000300111100011b1
111a111101500050070001111113555555551111111100001111b1
1000000001500050000001000000100003000000000001111111b1
101111111158585740674100000410000111111111111100000001
10000c000c00500051111100000610000100000000000005555555
1111111111115555511111000000101111bbbbbbbbbbbbb5000005
100001000010000000100300000410111100000000000005090905
1000000110a0111110001100000010000100000000000005009005
10000111001000cccccccccc0cccc0000100000000c00005090905
10000100011010100000010000001000010000000b0b0005009005
104001011110100010112100000030000a00000000c00008000005
111111111111111111111111111111111111111111111115555555
