1111111111
1111011001
1000000001
1110111101
1000000001
1111111111
