111111111111111111111111111111111111111111111111111111
111101100000000000000111111110111111000011000000100001
100000000011111111110300000030000003000030011110001101
111311110110001007000111111311111111111111110000111101
100000000110001000000100000010000300000000000111111101
101111111113131740674100000410000111111111111100000001
100000000000100011111100000610000100000000000001111111
111111111111111111111100000010111100000000000001000001
100001000010000000100300000410111100000000000001000001
100000011030111110001100000010000100000000000001000001
100001110010001111111100000010000100000000000001000001
100001000110101000000100000010000100000000000001000001
104001011110100010112100000030000300000000000003000001
111111111111111111111111111111111111111111111111111111
