111111111112222222221111111122211111111111111111111111
1111011000c0000000000111111120222222000011000000100001
100000c000122222222203c0ccc0300000080000300111100011b1
111a111101200020070001111113222222221111111100001111b1
1000000001200020000001000000100003000000000001111111b1
101111111128282740674100000410000111111111111100000001
10000c000c00200021111100000610000100000000000002222222
1111111111112222211111000000101111bbbbbbbbbbbbb2000002
100001000010000000100300000410111100000000000002090902
1000000110a01111100011000000100001000C0000000002009002
10000111001000cccccccccc0cccc0000100B0D000c00002090902
1000010001101010000001000000100001000A000b0b0002009002
10400101111010001011C100000030000a00000000c00008000002
111111111111111111111111111111111111111111111112222222
