111111111115555555551111111155511111111111111111111111
111101100000000000000111111150555555000011000000100001
100000000015555555550300000030000008000030011110001101
111a11110150005007000111111355555555111111110000111101
100000000150005000000100000010000300000000000111111101
101111111158585740674100000410000111111111111100000001
100000000000500051111100000610000100000000000005555555
111111111111555551111100000010111100000000000005000005
100001000010000000100300000410111100000000000005090905
1000000110a0111110001100000010000100000000000005009005
100001110010001111111100000010000100000000000005090905
100001000110101000000100000010000100000000000005009005
104001011110100010112100000030000a00000000000008000005
111111111111111111111111111111111111111111111115555555
